200000000111111111
011111110000000000
011111110111111101
011111111111111101
000000000000000101
111011111101111101
111011111101300001
000010100001111111
111010001100000000